{
    "map": [
        ["e", "r", "r", "r", "r", "r", "r", "r", "r", "r"],
        ["e", "r", "t", "t", "t", "t", "t", "t", "t", "r"],
        ["e", "r", "r", "r", "r", "t", "r", "r", "r", "r"],
        ["e", "e", "e", "e", "r", "t", "r", "e", "e", "e"],
        ["e", "e", "e", "e", "r", "t", "r", "e", "e", "e"],
        ["e", "e", "e", "e", "r", "t", "r", "e", "e", "e"],
        ["e", "e", "e", "e", "r", "t", "r", "e", "e", "e"],
        ["e", "e", "e", "e", "r", "t", "r", "e", "e", "e"],
        ["e", "e", "e", "e", "r", "t", "r", "e", "e", "e"],
        ["e", "e", "e", "e", "s", "t", "b", "e", "e", "e"]
    ],
    "waypoints": [
        { "X": 5, "Y": 9 },
        { "X": 5, "Y": 2 },
        { "X": 1, "Y": 2 },
        { "X": 1, "Y": 0 },
        { "X": 9, "Y": 0 },
        { "X": 9, "Y": 2 },
        { "X": 6, "Y": 2 },
        { "X": 6, "Y": 9 }
    ]
}
