{
    "map": [
        ["e", "e", "e", "e", "e", "e", "e", "e", "e", "e"],
        ["e", "r", "r", "r", "e", "e", "r", "r", "r", "e"],
        ["e", "r", "t", "r", "e", "e", "r", "t", "r", "e"],
        ["e", "r", "t", "r", "e", "e", "r", "t", "r", "e"],
        ["e", "r", "t", "r", "e", "e", "r", "t", "r", "e"],
        ["e", "r", "t", "r", "e", "e", "r", "t", "r", "e"],
        ["e", "r", "t", "r", "e", "e", "r", "t", "r", "e"],
        ["e", "r", "t", "r", "e", "e", "r", "t", "r", "e"],
        ["e", "r", "t", "r", "r", "r", "r", "t", "r", "e"],
        ["e", "b", "e", "e", "e", "e", "e", "e", "s", "e"]
    ],
    "waypoints": [
        { "X": 8, "Y": 9 },
        { "X": 8, "Y": 1 },
        { "X": 6, "Y": 1 },
        { "X": 6, "Y": 8 },
        { "X": 3, "Y": 8 },
        { "X": 3, "Y": 1 },
        { "X": 1, "Y": 1 },
        { "X": 1, "Y": 9 }
    ]
}
